******************************
+      **************    *****
***** ************** ** ******
***** *      ****    ** ******
*  **   **** **** ***** ******
** *********      ************
** ********* **** ************
**     ***** **** **** *******
****** ***** **** **** *******
****** ****** *** **** *******
****** ***    ***      *******
***    *** ****** **** *******
*** ****** ****** **** *******
* * ****        ******  ******
* * ***    **** ******       x
*   *** ******* **** *********
*** *** ******* ****** *******
*** *** *******     ** *******
***     ***********    *******
******************************