******************************
x      **************    *****
***** ************** ** ******
***** *      ****    ** ******
   **   **** **** ***** ******
** *********      ************
** ********* **** ************
**     ***** **** **** *******
****** ****** *** **** *******
****** ****** *** **** *******
****** ***    ***      *******
****   *** ****** **** *******
*** ****** ****** **** *******
  * ****      ********  ******
* * ***    **** *******       
*   *** ******* ****   *******
*** *** ******* ****** *******
*** *** *******     ** *******
***     ***********    *******
******************************